10
10
........*.
.*>...*.*.
........*.
.*..*.*.*.
..........
******..*.
..........
..*.*.*.*.
..........
.........x
          
          
          
